TW B  B  DL B  B  B  TW B  B  B  DL B  B  TW
B  DW B  B  B  TL B  B  B  TL B  B  B  DW B
B  B  DW B  B  B  DL B  DL B  B  B  DW B  B
DL B  B  DW B  B  B  DL B  B  B  DW B  B  DL
B  B  B  B  DW B  B  B  B  B  DW B  B  B  B
B  TL B  B  B  TL B  B  B  TL B  B  B  TL B
B  B  DL B  B  B  DL B  DL B  B  B  DL B  B
TW B  B  DL B  B  B  DW B  B  B  DL B  B  TW
B  B  DL B  B  B  DL B  DL B  B  B  DL B  B
B  TL B  B  B  TL B  B  B  TL B  B  B  TL B
B  B  B  B  DW B  B  B  B  B  DW B  B  B  B
DL B  B  DW B  B  B  DL B  B  B  DW B  B  DL
B  B  DW B  B  B  DL B  DL B  B  B  DW B  B
B  DW B  B  B  TL B  B  B  TL B  B  B  DW B
TW B  B  DL B  B  B  TW B  B  B  DL B  B  TW
